11111111111111111111
1E0000000000000C0C01
101011C10C1000001101
11100100111010110101
1P0000000C00C00000C1
11111111111111111111