1111111111111111111111111111111111
1E00000000000001000001000000000001
1000010100100000101001000000010101
10P0010010101010001001000000010101
1000000001001000000000000000000011
1111111111111111111111111111111111