1111111111111111111111111111111111
1000000000000000100000000000000001
1000000C000000001000000C0000000001
1000000000000000100000000000000001
1000P00000000000100000000000000E01
1111111111111111111111111111111111