
111111111111111111111111111111111
1100000000000001000001000000000001
1000010100100G00101001000000010100

10P001001010101000100100P000010101
100000000100100000000H000000000011
1111111111101111111111111111111
