1111111111111111111111111111111111
1E0000000000000C00000C000000000001
1000010100100000101001000000010101
10P0010010101010001001000000010100
100000000C00C0000000000000000000C1
1111111111111111111111111111111111