11111111111111111111111111111111111111111111111111111111111111
10000000000000000000000000000000000000000000000000000000000011
100000000000000000000000C0000000000000000000000000000000000011
100000000000000000P0000000000C000000000000000E0000000000000011
10000000000000000000000000000000000000000000000000000000000011
11111111111111111111111111111111111111111111111111111111111111