1111111111111111111111111111111111
1000P0000000000E00000000000C000011
1111111111111111111111111111111111